"filename", "language", "PHP", "Markdown", "Log", "JSON", "comment", "blank", "total"
"f:\Project\工作文件夹\MiraiTravel\.github\ISSUE_TEMPLATE\bug_report.md", "Markdown", 0, 30, 0, 0, 0, 9, 39
"f:\Project\工作文件夹\MiraiTravel\.github\ISSUE_TEMPLATE\feature_request.md", "Markdown", 0, 15, 0, 0, 0, 6, 21
"f:\Project\工作文件夹\MiraiTravel\CODE_OF_CONDUCT.md", "Markdown", 0, 93, 0, 0, 0, 36, 129
"f:\Project\工作文件夹\MiraiTravel\README.md", "Markdown", 0, 8, 0, 0, 0, 5, 13
"f:\Project\工作文件夹\MiraiTravel\components\easyMirai\V0.1.1\easyMirai.php", "PHP", 4, 0, 0, 0, -3, -1, 0
"f:\Project\工作文件夹\MiraiTravel\core\messageChain.php", "PHP", 19, 0, 0, 0, 6, 2, 27
"f:\Project\工作文件夹\MiraiTravel\core\miraiApiHttp.php", "PHP", 24, 0, 0, 0, 14, 6, 44
"f:\Project\工作文件夹\MiraiTravel\core\pluginSystem.php", "PHP", 7, 0, 0, 0, 0, 1, 8
"f:\Project\工作文件夹\MiraiTravel\core\qqObj.php", "PHP", 75, 0, 0, 0, 20, 7, 102
"f:\Project\工作文件夹\MiraiTravel\logs\webhook.log", "Log", 0, 0, 0, 0, 0, 1, 1
"f:\Project\工作文件夹\MiraiTravel\plugins\bilibiliFans\V0.1.0\config.json", "JSON", 0, 0, 0, 8, 0, 0, 8
"f:\Project\工作文件夹\MiraiTravel\plugins\groupManager\V0.1.0\config.json", "JSON", 0, 0, 0, 10, 0, 0, 10
"f:\Project\工作文件夹\MiraiTravel\plugins\groupManager\V0.1.0\groupManager.php", "PHP", 15, 0, 0, 0, 0, 1, 16
"f:\Project\工作文件夹\MiraiTravel\plugins\runoobC\V0.1.0\README.md", "Markdown", 0, 5, 0, 0, 0, 4, 9
"f:\Project\工作文件夹\MiraiTravel\plugins\runoobC\V0.1.0\config.json", "JSON", 0, 0, 0, 10, 0, 0, 10
"f:\Project\工作文件夹\MiraiTravel\script\Q2771717841.php", "PHP", 0, 0, 0, 0, 0, -1, -1
"f:\Project\工作文件夹\MiraiTravel\webhook.php", "PHP", 35, 0, 0, 0, 0, 0, 35
"Total", "-", 179, 151, 0, 28, 37, 76, 471